数の子	鲱鱼子
ツッコミ	吐槽
赤ちゃん	宝宝
幼馴染	青梅竹马
サキュバス	魅魔
ハイエルフ	高等精灵
ダークエルフ	暗精灵
ヴァンパイア	吸血鬼
ケダモノ	禽兽
責め	责难
先輩	前辈





















===================================
キンタマ	蛋蛋
口まんこ	嘴穴
オチンポ	肉棒
チンポ	肉棒
まんこ	小穴
膣	阴道
ドＭ	抖M
乳首	乳头
生挿入	无套插入
生チンポ	无套肉棒
生オチンポ	无套肉棒
ディルド	假阳具
ハリガタ	假阳具
バイブ	振动棒
生ディルド	人肉假阳具
生バイブ	人肉振动棒
生オナホ	人肉飞机杯